N ./inc/textures/wall_1.xpm
S ./inc/textures/wall_2.xpm   
W ./inc/textures/wall_3.xpm
E ./inc/textures/wall_4.xpm

F 255,255,255
C 255,128,128   

11111111111111111111111111111
10000000001100000000000000001
10110000011100000000000010001
10010000000000000000000010001
10110000011100000000000010001
10000000001100000111011110001
11110111111111011101000010001
11110111111111111100010010001
110000001101     10001100000111111
100000000001     10001100000000001
100000000001     10001100010111111
11000000110111111100000000001
11110111110101000001110000001
10000000001100000100000010001
10000000000000000000000001001
10000000001000010000000001001
10000000001101000000000000001
100000000001000000010000000W1
11111111111111111111111111111
