N /nfs/homes/mvicente/sgoinfre/cub3D/cub3D/inc/textures/wall_1.xpm
S /nfs/homes/mvicente/sgoinfre/cub3D/cub3D/inc/textures/wall_2.xpm  
W /nfs/homes/mvicente/sgoinfre/cub3D/cub3D/inc/textures/wall_3.xpm
E /nfs/homes/mvicente/sgoinfre/cub3D/cub3D/inc/textures/wall_4.xpm

F 255,0,0
C 255,0,0   

11111111111111
10000000000001
10000000000001
10010000000001
10000000000001
10010000000001
10000000001001
10000000000001
10000000N00001
10000000000001
11111111111111
