N ./inc/textures/wall_1.xpm
S ./inc/textures/wall_2.xpm  
W ./inc/textures/wall_3.xpm
E ./inc/textures/wall_4.xpm

F 100,255,255
C 128,120,128   

11111111111111111111111111111
10000000000000000000000001001
10000000001000010000100001001
10000000001101000000000001001
10000000000100000001000001001
10000000000000000000000001001
10000100000000000000000000001
10000000000000000000E00000001
10000100000000000000000010001
10000000000000000000000000001
11111111111111111111111111111
