N ./inc/textures/north
S ./inc/textures/south   
W ./inc/textures/west
E ./inc/textures/east

F 255,0,0
C 255,0,0   

11111111111111
10010000000001
10010000001001
10010001001001
10000000001001
10000000000001
10000000001111
10000000000001
10000000N00001
11000000000001
11111111111111
