N ./inc/textures/wall_1.xpm
S ./inc/textures/wall_2.xpm   
W ./inc/textures/wall_3.xpm
E ./inc/textures/wall_4.xpm

F 255,255,255
C 016,128,128   

11111111111111111111111111111
100000000011000000000000000011
1101100000111000000000000100011
11111111111111111001000000000011
101100000111000000000000100011111111111111111
10000000001100000111011110001
11110111111111011101000010001
11110111111111111100010010001
110000001101     10001100000111111
100000000001     10001100000111111
100000000001     10001100010111111
1100000011011111110000000000111111
1111011111010100000111000000111111
10000000001100000100000010001
10000000000000000000000001001
10000000001000010000000001001
10000000001101000000000000001
100000000001000000010000000N1
11111111111111111111111111111
