  111111
  100001
1110000111
1000000001
1000000001
1000000001
1000000001
1110000111
  100001
  111111